=== level5 room 7 ===
+---+---------------------------------------------------------------------------------+
| y |    0    1    2    3    4    5    6    7    8    9   10   11   12   13   14   15 |
+---+---------------------------------------------------------------------------------+
| 0 |    1    1    1    1    1    1    1    1    1    1    1    1    0    0    1    1 |
|   |                                                                                 |
| 1 |    1    1    0    0    1    1    0    0    0    0    0    0    0    0    1    1 |
|   |                                                                                 |
| 2 |    1    1    0    0    0    0    0    0    0    0    0    0    0    0    1    1 |
|   |                                                                                 |
| 3 |    1    1    0    0    0    0    0    0    0    0    0    0    0    0    1    1 |
|   |                                                                                 |
| 4 |    1    1    1    1    1    1    1    1    0    0    1    1    1    1    1    1 |
|   |                                                                                 |
| 5 |    1    1    1    1    1    1    1    1    0    0    1    1    1    1    1    1 |
|   |                                                                                 |
| 6 |    1    1    1    1    1    1    1    1    0    0    1    1    1    1    1    1 |
|   |                                                                                 |
+---+---------------------------------------------------------------------------------+