=== level2 room 8 ===
+---+---------------------------------------------------------------------------------+
| y |    0    1    2    3    4    5    6    7    8    9   10   11   12   13   14   15 |
+---+---------------------------------------------------------------------------------+
| 0 |    1    1    0    0    0    0    1    1    1    1    1    1    1    1    1    1 |
|   |                                                                                 |
| 1 |    1    1    0    0    0    0    1    1    0    0    0    0    1    1    0    0 |
|   |                                                                                 |
| 2 |    1    1    0    0    0    0    1    1    0    0    0    0    1    1    0    0 |
|   |                                                                                 |
| 3 |    1    1    0    0    0    0    1    1    0    0    0    0    1    1    0    0 |
|   |                                                                                 |
| 4 |    1    1    0    0    0    0    1    1    0    0    0    0    1    1    0    0 |
|   |                                                                                 |
| 5 |    1    1    0    0    0    0    1    1    0    0    0    0    0    0    0    0 |
|   |                                                                                 |
| 6 |    1    1    0    0    0    0    1    1    0    0    1    1    1    1    1    1 |
|   |                                                                                 |
+---+---------------------------------------------------------------------------------+